the	definite-article,adverb
of	preposition,auxiliary-verb
and	conjunction
to	preposition,adverb
a	indefinite-article,noun,preposition
in	preposition,adverb
is	verb
you	pronoun,noun
are	verb
for	preposition,conjunction
that	pronoun,adjective,adverb,conjunction
or	conjunction
it	pronoun,noun
as	adverb,conjunction,pronoun,preposition
be	verb,auxiliary-verb
on	preposition,adverb,adjective
your	pronoun
with	preposition
can	auxiliary-verb,noun
have	verb,auxiliary-verb
this	pronoun,adjective,adverb
an	indefinite-article
by	preposition,adverb
not	adverb
but	conjunction,preposition,adverb,noun
at	preposition
from	preposition
I	pronoun
they	pronoun
more	adjective,adverb
will	auxiliary-verb,noun
if	conjunction,noun
some	adjective,pronoun,adverb
there	adverb,pronoun,noun,adjective
what	pronoun,adjective,adverb,interjection
about	preposition,adverb,adjective
which	pronoun,adjective
when	adverb,conjunction
one	adjective,noun,pronoun
their	pronoun
all	adjective,pronoun,noun,adverb
also	adverb
how	adverb,conjunction
many	adjective,noun,pronoun
do	auxiliary-verb
has	verb
most	adjective,noun,adverb
people	noun
other	adjective,noun,pronoun,adverb
time	noun,adjective,verb
so	adverb,conjunction,pronoun,adjective
was	past,verb
we	pronoun
these	pronoun,adjective
may	auxiliary-verb
like	preposition,verb,conjunction,adverb
use	verb,noun
into	preposition
than	conjunction
up	adverb,preposition,adjective,noun
out	adverb,preposition,adjective,interjection
who	pronoun
them	pronoun
make	verb,noun
because	conjunction
such	adjective,adverb
through	preposition,adverb,adjective
get	verb
work	noun,adjective,verb
even	adjective,verb,adverb
different	adjective
its	pronoun
no	adverb,adjective,noun
our	pronoun
new	adjective,adverb
film	noun,verb
just	adjective,adverb
only	adverb,adjective,conjunction
see	verb
used	adjective
good	adjective,noun,adverb,interjection
water	noun,verb,adjective
been	past,verb
need	verb
should	auxiliary-verb
very	adverb
any	adjective,adverb
history	noun
often	adverb
way	noun
well	adverb,verb,noun,interjection
art	noun
know	verb
were	past,verb
then	adverb,adjective
my	pronoun
first	adverb,adjective
would	verb
money	noun,adjective
each	adjective,adverb
over	preposition,adjective,noun
world	noun
information	noun
map	noun
find	verb
where	adverb,pronoun,noun
much	adjective,adverb
take	verb
two	noun
want	verb
important	adjective
family	noun
those	pronoun
example	noun,verb
while	noun,conjunction,preposition,verb
he	pronoun
look	verb,noun,interjection
government	noun
before	preposition,adverb,conjunction
help	verb,noun,interjection
between	preposition,adverb
go	verb,noun,adjective,interjection
own	adjective,verb
however	adverb
business	noun,adjective
us	pronoun
great	adjective,noun,adverb,interjection
his	pronoun,adjective
being	verb,noun
another	adjective,pronoun
health	noun
same	adjective,pronoun,adverb
study	noun,verb
why	adverb,conjunction,noun,interjection
few	adjective,noun,pronoun
game	noun,adjective,verb
might	auxiliary-verb,noun
think	verb,adjective,noun
free	adjective,adverb,verb
too	adverb
had	auxiliary-verb
hi	interjection
right	adjective,adverb,noun,verb
still	adjective,noun,adverb,verb
system	noun
after	preposition,adjective,adverb
computer	noun
best	adjective,adverb,noun,verb
must	auxiliary-verb,verb,adjective,noun
her	pronoun
life	noun,adjective
since	preposition,adverb,conjunction
could	auxiliary-verb
does	verb
now	adverb,conjunction,adjective
during	preposition
learn	verb
around	adverb,preposition
usually	adverb
form	noun,verb
meat	noun
air	noun,verb
day	noun,adjective
place	noun,verb
become	verb
number	noun,verb
public	adjective,noun
read	verb,noun
keep	verb,noun
part	noun,verb,adverb
start	verb,noun
year	noun
every	adjective
field	noun,verb,adjective
large	adjective
once	adverb,conjunction
available	adjective
down	adverb,preposition,adjective,verb
give	verb,noun
fish	noun,verb
human	adjective,noun
both	adjective,adverb
local	adjective,noun
sure	adjective,adverb
something	pronoun
without	preposition,adverb,conjunction
come	verb
me	pronoun
back	noun,adverb,verb,adjective
better	adjective,adverb,noun,verb
general	adjective,noun
process	noun,verb
she	pronoun,noun
heat	noun,verb
thanks	noun
specific	adjective,noun
enough	adjective,adverb,interjection
long	adjective,noun,adverb,verb
lot	pronoun,adverb,noun,verb
hand	noun,verb
popular	adjective
small	adjective,adverb
though	conjunction,adverb
experience	noun,verb
include	verb
job	noun,verb
music	noun
person	noun
really	adverb
although	conjunction
thank	verb
book	noun,verb
early	adverb
reading	noun
end	noun,verb
method	noun
never	adverb
less	adjective,adverb,preposition
play	verb,noun
able	adjective
data	noun
feel	verb,noun
high	adjective,noun,adverb
off	adverb,preposition,adjective,noun
point	noun,verb
type	noun,verb
whether	conjunction
food	noun
understanding	noun
here	adverb,interjection
home	noun,adjective,adverb,verb
certain	adjective,pronoun
economy	noun,adjective
little	adjective,adverb
theory	noun
tonight	adverb,noun
law	noun
put	verb,noun
under	preposition,adverb,adjective
value	noun,verb
always	adverb
body	noun,verb
common	adjective,noun
market	noun,verb
set	verb,noun,adjective
bird	noun
guide	noun,verb
provide	verb
change	verb,noun
interest	noun,verb
literature	noun
sometimes	adverb
problem	noun
say	verb,interjection,noun
next	adjective,adverb,noun
create	verb
simple	adjective,noun
software	noun
state	noun,verb
together	adverb
control	noun
knowledge	noun
power	noun
radio	noun,verb
ability	noun
basic	adjective
course	noun,verb
economics	noun
hard	adjective,adverb
add	verb
company	noun,verb
known	adjective
love	noun
past	adjective,noun,preposition,adverb
price	noun,verb
size	noun,verb,adjective
away	adverb,adjective
big	adjective,noun
internet	noun
possible	adjective,noun
television	noun
three	number
understand	verb
various	adjective
yourself	pronoun
card	noun,verb
difficult	adjective
including	preposition
list	noun,verb
mind	noun,verb
particular	adjective,noun
real	adjective,adverb,noun
science	noun
trade	noun,verb
consider	verb
either	conjunction,adjective
library	noun
likely	adverb
nature	noun
fact	noun
line	noun,verb
product	noun
care	noun,verb
group	noun,verb
idea	noun
risk	noun,verb
several	adjective
someone	pronoun
temperature	noun
united	adjective
word	noun,verb,interjection
fat	noun,adjective,verb
force	noun,verb
key	noun,adjective,verb
light	noun,verb,adjective
simply	adverb
today	adverb,noun
training	noun,adjective
until	preposition
major	adjective,noun,verb
name	noun,verb,adjective
personal	adjective,noun
school	noun,verb
top	noun,adjective,verb
current	adjective,noun
generally	adverb
historical	adjective
investment	noun
left	adjective,adverb
national	adjective,noun
amount	noun,verb
level	noun,adjective,verb
order	noun,verb
practice	noun,verb
research	noun,verb
sense	noun,verb
service	noun,verb
area	noun
cut	verb,noun
hot	adjective
instead	adverb
least	adjective,adverb
natural	adjective,noun,adverb
physical	adjective,noun
piece	noun,verb
show	verb,noun
society	noun
try	verb,noun
check	verb,noun,interjection
choose	verb
develop	verb
second	number,noun
useful	adjective
web	noun,verb
activity	noun
boss	noun,verb,adjective
short	adjective,adverb,noun,verb
story	noun
call	verb,noun
industry	noun
last	adjective,adverb,noun,verb
media	noun
mental	adjective
move	verb,noun
pay	verb,noun
sport	noun,verb
thing	noun
actually	adverb
against	preposition
far	adverb,adjective
fun	noun,adjective,verb
house	noun,adjective,verb
let	verb,noun
page	noun,verb
remember	verb
term	noun,verb
test	noun,verb
within	preposition,adverb
along	preposition,adverb
answer	noun,verb
increase	verb,noun
oven	noun
quite	adverb,interjection
scared	adjective
single	adjective,noun,verb
sound	noun,verb,adjective
again	adverb
community	noun
definition	noun
focus	noun,verb
individual	adjective,noun
matter	noun,verb
safety	noun
turn	verb,noun
everything	pronoun
kind	noun,adjective
quality	noun
soil	noun,verb
ask	verb,noun
board	noun,verb
buy	verb,noun
development	noun
guard	verb,noun
hold	verb,noun
language	noun
later	adverb,interjection
main	adjective,noun
offer	verb,noun
oil	noun,verb
picture	noun,verb
potential	adjective,noun
professional	adjective,noun
rather	adverb
access	noun,verb,adjective
additional	adjective
almost	adverb
especially	adverb
garden	noun,verb
international	adjective,noun
lower	adjective,adverb
management	noun
open	adjective,verb,noun
player	noun
range	noun,verb
rate	noun,verb
reason	noun,verb
travel	verb,noun
variety	noun
video	noun
week	noun
above	adverb,preposition,adjective,noun
according	adjective,verb
cook	verb,noun
determine	verb
future	noun,adjective
site	noun,verb
alternative	adjective,noun
demand	noun,verb
ever	adverb
exercise	noun,verb
following	preposition,noun,adjective
image	noun,verb
quickly	adverb
special	adjective,noun
working	adjective,noun
case	noun,verb
cause	noun,verb
coast	noun,verb
probably	adverb
security	noun
true	adjective,adverb,verb
whole	adjective,noun,adverb
action	noun,adjective
age	noun,verb
among	preposition
bad	noun,adverb,adjective
boat	noun,verb
country	noun
dance	verb,noun
exam	noun
excuse	verb,noun
grow	verb
movie	noun
organization	noun
record	noun,verb
result	noun,verb
section	noun,verb
across	preposition,adverb,adjective
already	adverb
below	adverb
building	noun,verb
mouse	noun,verb
allow	verb
cash	noun,verb
class	noun,verb,adjective
clear	adjective,adverb,verb
dry	adjective,verb,noun
easy	adjective,adverb,interjection
emotional	adjective
equipment	noun
live	verb,adjective,adverb
nothing	noun,pronoun,adjective,adverb
period	noun,adjective
physics	noun
plan	noun,verb
store	noun,verb
tax	noun,verb
analysis	noun
cold	adjective,noun,adverb
commercial	adjective,noun
directly	adverb
full	adjective,adverb,noun,verb
involved	past,verb
itself	pronoun
low	adjective,noun,adverb,verb
old	adjective
policy	noun
political	adjective
purchase	verb,noun
series	noun
side	noun,verb
subject	noun,adjective,adverb,verb
supply	verb
therefore	adverb
thought	noun
basis	noun
boyfriend	noun
deal	verb,noun
direction	noun
mean	verb,adjective,noun
primary	adjective,noun
space	noun,verb
strategy	noun
technology	noun
worth	adjective,noun
army	noun
camera	noun
fall	verb,noun
freedom	noun
paper	noun
rule	noun,verb
similar	adjective
stock	noun,adjective,verb
weather	noun,verb
yet	adverb,conjunction
bring	verb
chance	noun,adjective,verb
environment	noun
everyone	pronoun
figure	noun,verb
improve	verb
man	noun,verb,interjection
model	noun,verb
necessary	adjective,noun
positive	adjective,noun
produce	verb,noun
search	verb,noun
source	noun,verb
beginning	noun,adjective,verb
child	noun
earth	noun,verb
else	adverb
healthy	adjective
instance	noun
maintain	verb
month	noun
present	adjective,noun,verb
program	noun,verb
spend	verb,noun
talk	verb,noun
truth	noun
upset	verb,adjective
begin	verb
chicken	noun,adjective
close	adjective,adverb,verb,noun
creative	adjective,noun
design	noun,verb
feature	noun,verb
financial	adjective
head	noun,adjective,verb
marketing	noun
material	noun,adjective
medical	adjective
purpose	noun,verb
question	noun,verb
rock	noun,verb
salt	noun,adjective,verb
tell	verb,noun
themselves	pronoun
traditional	adjective
university	noun
writing	noun
act	noun,verb
article	noun
birth	noun,verb
car	noun,adjective
cost	verb,noun
department	noun
difference	noun
dog	noun,verb
drive	verb,noun
exist	verb
federal	adjective
goal	noun
green	adjective,noun,verb
late	adjective,adverb,noun
news	noun
object	noun,verb
scale	noun,verb
sun	noun,verb
support	verb,noun
tend	verb
thus	adverb
audience	noun
enjoy	verb
entire	adjective
fishing	noun
fit	adjective,verb,noun
glad	adjective,noun
growth	noun
income	noun
marriage	noun
note	noun,verb
perform	verb
profit	noun,verb
proper	adjective,adverb,noun
related	past,verb
remove	verb,noun
rent	noun,verb
return	verb,noun
run	verb,noun
speed	noun,verb
strong	adjective
style	noun,verb
throughout	preposition
user	noun
war	noun,verb
actual	adjective
appropriate	verb,adjective
bank	noun,verb
combination	noun
complex	adjective,noun,verb
content	adjective,verb,noun
craft	noun,verb
due	adjective,noun,adverb
easily	adverb
effective	adjective,noun
eventually	adverb
exactly	adverb
failure	noun
half	noun,predeterminer,adverb
inside	noun,adjective,preposition
meaning	noun
medicine	noun
middle	adjective,noun
outside	noun,adjective,preposition
philosophy	noun
regular	adjective,noun
reserve	verb,noun
standard	noun,adjective
bus	noun,verb
decide	verb
exchange	noun,verb
eye	noun,verb
fast	adjective,adverb,verb
fire	noun,verb
identify	verb
independent	adjective,noun
leave	verb,noun
original	adjective,noun
position	noun,verb
pressure	noun,verb
reach	verb,noun
rest	verb,noun
serve	verb,noun
stress	noun,verb
teacher	noun
watch	verb,noun
wide	adjective,adverb
advantage	noun,verb
beautiful	adjective,noun,interjection
benefit	noun,verb
box	noun,verb
charge	verb,noun
communication	noun
complete	adjective,verb
continue	verb
frame	noun,verb
issue	noun,verb
limited	past,verb
night	noun
protect	verb
require	verb
significant	adjective
step	noun,verb
successful	adjective
unless	conjunction
active	adjective,noun
break	verb,noun
chemistry	noun
cycle	noun,verb
disease	noun
disk	noun
electrical	adjective
energy	noun
expensive	adjective
face	noun,verb
interested	past,verb
item	noun,adverb
metal	noun,verb
nation	noun
negative	adjective,noun,interjection,verb
occur	verb
paint	noun,verb
pregnant	adjective
review	noun,verb
road	noun
role	noun
room	noun,verb
safe	adjective,noun
screen	noun,verb
soup	noun
stay	verb,noun
structure	noun,verb
view	noun,verb
visit	verb,noun
visual	adjective,noun
write	verb
wrong	adjective,adverb,noun,verb
account	noun,verb
advertising	noun
affect	verb,noun
ago	adjective,adverb
anyone	pronoun
approach	verb
avoid	verb
ball	noun,verb
behind	preposition,adverb,adjective,noun
certainly	adverb
concerned	past,verb
cover	verb,noun
discipline	noun,verb
location	noun
medium	noun,adjective
normally	adverb
prepare	verb
quick	adjective,adverb,noun
ready	adjective,verb
report	verb,noun
rise	verb,noun
share	noun,verb
success	noun
addition	noun
apartment	noun
balance	noun,verb
bit	noun,verb
black	noun,verb,adjective,adverb
bottom	noun,verb,adjective
build	verb
choice	noun,adjective
education	noun
gift	noun,verb
impact	noun,verb
machine	noun,verb
math	noun
moment	noun
painting	noun
politics	noun
shape	noun,verb
straight	adjective,adverb,noun
tool	noun,verb
walk	verb,noun
white	adjective,noun,verb
wind	noun,verb
achieve	verb
address	noun,verb
attention	noun
average	noun,verb,adjective
believe	verb
beyond	preposition,noun
career	noun,verb,adjective
culture	noun,verb
decision	noun
direct	adjective,adverb,verb
event	noun
excellent	adjective,interjection
extra	adjective,adverb,noun
intelligent	adjective
interesting	adjective
junior	adjective,noun
morning	noun,adverb
pick	verb,noun
poor	adjective
pot	noun,verb
pretty	adjective,adverb,noun,verb
property	noun
receive	verb
seem	verb
shopping	noun
sign	noun,verb
student	noun
table	noun,verb
task	noun,verb
unique	adjective,noun
wood	noun
anything	pronoun,noun,adverb
classic	adjective,noun
competition	noun
condition	noun,verb
contact	noun,verb
credit	noun,verb
currently	adverb
discuss	verb
distribution	noun
egg	noun,verb
entertainment	noun
final	adjective,noun
happy	adjective
hope	noun,verb
ice	noun,verb
lift	verb,noun
mix	verb,noun
network	noun,verb
north	noun,adjective,adverb
office	noun
overall	adjective,adverb,noun
population	noun
president	noun
private	adjective,noun
realize	verb
responsible	adjective
separate	adjective,verb,noun
square	noun,adjective,adverb
stop	verb,noun
teach	verb,noun
unit	noun
western	adjective,noun
yes	interjection
alone	adjective,adverb
attempt	noun,verb
category	noun
cigarette	noun
concern	verb,noun
contain	verb
context	noun
cute	adjective
date	noun,verb
effect	noun,verb
extremely	adverb
familiar	adjective,noun
finally	adverb
fly	verb,noun
follow	verb
helpful	adjective
introduction	noun
link	noun,verb
official	adjective,noun
opportunity	noun
perfect	adjective,verb,noun
performance	noun
post	noun,verb,adverb
recent	adjective
refer	verb
solve	verb
star	noun,verb
voice	noun,verb
willing	adjective
born	verb,adjective,past-particple
bright	adjective,adverb,noun
broad	adjective,noun
capital	noun,adjective
challenge	noun,verb,adjective
comfortable	adjective,noun
constantly	adverb
describe	verb
despite	preposition
driver	noun
flat	adjective,adverb,noun,verb
flight	noun
friend	noun,verb
gain	verb,noun
him	pronoun
length	noun
magazine	noun
maybe	adverb,noun
newspaper	noun
nice	adjective
prefer	verb
prevent	verb
properly	adverb
relationship	noun
rich	adjective,noun
save	verb,noun,preposition
self	noun,pronoun,adjective,verb
shot	noun,adjective
soon	adverb
specifically	adverb
stand	verb,noun
teaching	noun
warm	adjective,verb
wonderful	adjective
young	adjective,noun
ahead	adverb
brush	noun,verb
cell	noun
couple	noun,verb
daily	adverb
dealer	noun
debate	noun,verb
discover	verb
ensure	verb
exit	noun,verb
expect	verb
experienced	past,verb
fail	verb,noun
finding	noun
front	noun,adjective,verb,interjection
function	noun,verb
heavy	adjective,noun,adverb
hello	interjection,noun
highly	adverb
immediately	adverb
impossible	adjective
invest	verb
lack	noun,verb
lake	noun
lead	verb,noun
listen	verb,noun
living	noun,adjective
member	noun
message	noun
phone	noun
plant	noun,verb
plastic	noun,adjective
reduce	verb
relatively	adverb
scene	noun
serious	adjective
slowly	adverb
speak	verb
spot	noun,verb
summer	noun,verb
taste	noun,verb
theme	noun,verb
towards	preposition
track	noun,verb
valuable	adjective,noun
whatever	pronoun,adverb,interjection
wing	noun,verb
worry	verb,noun
appear	verb
appearance	noun
association	noun
brain	noun,verb
button	noun,verb
click	noun,verb
concept	noun
correct	adjective,verb
customer	noun
death	noun
desire	noun,verb
discussion	noun
explain	verb
explore	verb
express	verb,adjective,adverb,noun
fairly	adverb
fixed	past,verb
foot	noun,verb
gas	noun,verb
handle	verb,noun
housing	noun
huge	adjective
inflation	noun
influence	noun,verb
insurance	noun
involve	verb
leading	adjective,noun
lose	verb
meet	verb,noun
mood	noun
notice	noun,verb
primarily	adverb
rain	noun,verb
rare	adjective
release	verb,noun
sell	verb,noun
slow	adjective,adverb,verb
technical	adjective
typical	adjective
upon	preposition
wall	noun,verb
woman	noun
advice	noun
afford	verb
agree	verb
base	noun,verb,adjective
blood	noun
clean	adjective,adverb,verb
competitive	adjective
completely	adverb
critical	adjective
damage	noun,verb
distance	noun,verb
effort	noun
electronic	adjective
expression	noun
feeling	noun,adjective
finish	verb,noun
fresh	adjective,adverb
hear	verb
immediate	adjective
importance	noun
normal	adjective,noun
opinion	noun
otherwise	adverb,adjective
pair	noun,verb
payment	noun
plus	preposition,adjective,noun,conjunction
press	verb,noun
reality	noun
remain	verb
represent	verb
responsibility	noun
ride	verb,noun
savings	noun,adjective,preposition
secret	adjective,noun
situation	noun
skill	noun
spread	verb,noun
spring	verb,noun
staff	noun,verb
statement	noun
sugar	noun,verb
target	noun,verb
text	noun,verb
tough	adjective,noun
ultimately	adverb
wait	verb,noun
wealth	noun
whenever	conjunction,adverb
whose	pronoun
widely	adverb
animal	noun,adjective
application	noun
apply	verb
author	noun,verb
aware	adjective
brown	adjective,noun,verb
budget	noun,adjective,verb
cheap	adjective,adverb
city	noun
complicated	past,verb
county	noun
deep	adjective,noun,adverb
depth	noun
discount	noun,verb,adjective
display	verb,noun
educational	adjective
environmental	adjective
estate	noun
file	noun,verb
flow	verb,noun
forget	verb
foundation	noun
global	adjective
grandmother	noun
ground	noun,verb,adjective
heart	noun
hit	verb,noun
legal	adjective
lesson	noun,verb
minute	noun,adjective,verb
near	adverb,preposition,adjective,verb
objective	adjective,noun
officer	noun,verb
perspective	noun
phase	noun,verb
photo	noun
recently	adverb
recipe	noun
recommend	verb
reference	noun,verb,adjective
register	noun,verb
relevant	adjective
rely	verb
secure	adjective,verb
seriously	adverb
shoot	verb,noun,interjection
sky	noun,verb
stage	noun,verb
stick	noun,verb
studio	noun
thin	adjective,adverb,verb
title	noun,verb
topic	noun
touch	verb,noun
trouble	noun,verb
vary	verb
accurate	adjective
advanced	past,verb,adjective,noun
bowl	noun,verb
bridge	noun,verb
campaign	noun,verb
cancel	verb,noun
capable	adjective
character	noun,adjective,verb
chemical	adjective,noun
club	noun,verb
collection	noun
cool	adjective,adverb,noun,verb
cry	verb,noun,idiom
dangerous	adjective
depression	noun
dump	verb,noun,idiom
edge	noun,verb,idiom
evidence	noun,verb,idiom
extreme	adjective,noun
fan	noun,verb,idiom
frequently	adverb
fully	adverb
generate	verb
imagination	noun
letter	noun,verb,idiom
lock	noun,verb,idiom
maximum	noun,adjective
mostly	adverb
myself	pronoun
naturally	adverb
nearly	adverb
novel	noun,adjective
obtain	verb
occasionally	adverb
option	noun,verb
organized	past,verb
pack	noun,verb,adjective,idiom
park	noun,verb
passion	noun
percentage	noun
plenty	noun,adjective,adverb
push	verb,noun,idiom
quarter	noun,verb,adjective
resource	noun
select	verb,adjective
setting	noun
skin	noun,verb
sort	noun,verb
weight	noun,verb
accept	verb
ad	noun
agency	noun
baby	noun,verb,adjective
background	noun,adjective
carefully	adverb
carry	noun,verb
clearly	adverb
college	noun
communicate	verb
complain	verb
conflict	verb,noun
connection	noun
criticism	noun
debt	noun
depend	verb
description	noun
die	verb,idiom
dish	noun,verb,idiom
dramatic	adjective
eat	verb,noun,idiom
efficient	adjective
enter	verb
essentially	adverb
exact	adjective,verb
factor	noun,verb
fair	adjective,adverb,noun,idiom
fill	verb,noun,idiom
fine	adjective,adverb,verb,noun
formal	adjective,noun,adverb
forward	adverb,adjective,noun,verb
fruit	noun,verb
glass	noun,adjective,verb
happen	verb
indicate	verb
joint	noun,adjective,verb,idiom
jump	verb,noun,adjective,adverb
kick	verb,noun,idiom
master	noun,adjective,verb
memory	noun
muscle	noun,verb,adjective
opposite	adjective,noun,preposition,adverb
pass	verb,noun,idiom
patience	noun
pitch	verb,noun
possibly	adverb
powerful	adjective
red	noun,adjective,idiom
remote	adjective,noun
secretary	noun
slightly	adverb
solution	noun
somewhat	adverb
strength	noun,idiom
suggest	verb
survive	verb
total	adjective,noun,verb
traffic	noun,verb
treat	verb,noun
trip	noun,verb,idiom
vast	adjective,noun
vegetable	noun,adjective
abuse	verb,noun
administration	noun
appeal	noun,verb
appreciate	verb
aspect	noun
attitude	noun
beat	verb,noun,adjective
burn	verb,noun
chart	noun,verb
compare	verb
deposit	verb,noun
director	noun
equally	adverb
foreign	adjective
gear	noun,verb,adjective,idiom
greatly	adverb
hungry	adjective
ideal	noun,adjective
imagine	verb
kitchen	noun,adjective
land	noun,verb,idiom
log	noun,verb
lost	adjective,verb,idiom
manage	verb
mother	noun,adjective,verb,idiom
necessarily	adverb
net	noun,verb
party	noun,adjective,verb
personality	noun
personally	adverb
practical	adjective
principle	noun,idiom
print	verb,noun,adjective,idiom
psychological	adjective
psychology	noun
raise	verb,noun,idiom
rarely	adverb
recommendation	noun
regularly	adverb
relative	noun,adjective
response	noun
sale	noun,idiom
season	noun,verb,idiom
selection	noun
severe	adjective
signal	noun,adjective,verb
similarly	adverb
sleep	verb,noun,idiom
smooth	adjective,adverb,verb,noun
somewhere	adverb,noun
spirit	noun,verb,idiom
storage	noun
street	noun,adjective,idiom
suitable	adjective
tree	noun,verb,idiom
version	noun
wave	noun,verb,idiom
advance	verb,noun,adjective
alcohol	noun
anywhere	adverb,noun
argument	noun
basically	adverb
belt	noun,verb
bench	noun,verb
closed	past,verb
closely	adverb
commission	noun,verb
complaint	noun
connect	verb,adjective
consist	verb,noun
contract	noun
contribute	verb,idiom
copy	noun,verb,idiom
dark	adjective,noun,idiom
differ	verb
double	adjective,noun,verb,adverb
draw	verb,noun,idiom
drop	noun,verb
effectively	adverb
emphasis	noun
encourage	verb
equal	adjective,noun,verb
everybody	pronoun
expand	verb
firm	adjective,verb,adverb,noun
fix	verb,noun,idiom
frequent	adjective,verb
highway	noun
hire	verb,noun,adjective,idiom
initially	adverb
internal	adjective,noun
join	verb,noun
kill	verb,noun,idiom
literally	adverb
loss	noun
mainly	adverb
membership	noun
merely	adverb
minimum	noun,adjective
numerous	adjective
path	noun,idiom
possession	noun
preparation	noun
progress	noun,verb,idiom
project	noun,verb
prove	verb
react	verb
recognize	verb
relax	verb
replace	verb
sea	noun,adjective,idiom
sensitive	adjective,noun
sit	verb,idiom
south	noun,adjective,adverb,verb
status	noun,adjective
steak	noun
stuff	noun,verb
sufficient	adjective
tap	verb,noun
ticket	noun,verb,idiom
tour	noun,verb
union	noun
unusual	adjective
win	verb,noun
agreement	noun
angle	noun,verb
attack	verb,noun
blue	noun,verb,adjective
borrow	verb
breakfast	noun,verb
cancer	noun
claim	verb,noun
confidence	noun,idiom
consistent	adjective
constant	adjective,noun
cultural	adjective
currency	noun
daughter	noun,adjective
degree	noun,idiom
doctor	noun,verb
dot	noun,verb,idiom
drag	verb,noun,adjective,idiom
dream	noun,verb,adjective
drink	verb,noun
duty	noun,idiom
earn	verb
emphasize	verb
employment	noun
enable	verb
engineering	noun
entry	noun
essay	noun,verb
existing	adjective
famous	adjective
father	noun,verb
fee	noun,verb
finance	noun,verb
gently	adverb
guess	verb,noun,idiom
hopefully	adverb
hour	noun,adjective,idiom
interaction	noun
juice	noun,verb,idiom
limit	noun,verb
luck	noun,verb,idiom
milk	noun,verb,idiom
minor	adjective,noun,verb
mixed	past,verb
mixture	noun
mouth	noun,verb,idiom
nor	conjunction
operate	verb
originally	adverb
peace	noun,interjection,verb,idiom
pipe	noun,verb
please	adverb,verb,idiom
preference	noun
previous	adjective,idiom
pull	verb,noun
pure	adjective
raw	adjective,noun,idiom
reflect	verb
region	noun
republic	noun
roughly	adverb
seat	noun,verb
send	verb
significantly	adverb
soft	adjective,noun,adverb,interjection
solid	adjective,noun
stable	noun,verb
storm	noun,verb,idiom
substance	noun,idiom
team	noun,verb,adjective
tradition	noun
trick	noun,adjective,verb,idiom
virus	noun
wear	verb,noun,idiom
weird	adjective,noun
wonder	verb,noun,idiom
actor	noun
afraid	adjective
afternoon	noun,adjective
amazing	adjective,verb
annual	adjective,noun
anticipate	verb
assume	verb
bat	noun,verb
beach	noun,verb
blank	noun,verb,adjective
busy	adjective,verb
catch	noun,verb
chain	noun,verb
classroom	noun
consideration	noun,idiom
count	verb,noun,adjective,idiom
cream	noun,verb,adjective,idiom
crew	noun,verb
dead	adjective,noun,adverb,idiom
delivery	noun
detail	noun,verb,idiom
detailed	past,verb
device	noun
difficulty	noun
doubt	verb,noun,idiom
drama	noun
election	noun
engage	verb
engine	noun
enhance	verb
examine	verb
false	adjective,adverb,idiom
feed	verb,noun,idiom
football	noun
forever	adverb,noun,idiom
gold	noun,adjective
guidance	noun
hotel	noun
impress	verb,noun
install	verb
interview	noun,verb
kid	noun,verb,adjective
mark	noun,verb,idiom
match	noun,verb
mission	noun,adjective
nobody	pronoun,noun
obvious	adjective
ourselves	pronoun
owner	noun
pain	noun,verb,idiom
participate	verb
pleasure	noun,verb
priority	noun
protection	noun
repeat	verb,noun
round	adjective,noun,adverb,verb
score	noun,verb,idiom
screw	noun,verb,idiom
seek	verb,idiom
sex	noun,verb,idiom
sharp	adjective,verb,adverb,noun
shop	noun,verb,interjection,idiom
shower	noun,verb,idiom
sing	verb,noun
slide	verb,noun,idiom
strip	verb,noun
suggestion	noun
suit	noun,verb,idiom
tension	noun
thick	adjective,adverb,noun,idiom
tone	noun,verb
totally	adverb
twice	adverb
variation	noun
whereas	conjunction,noun
window	noun,verb
wise	adjective,verb,idiom
wish	verb,noun
agent	noun,adjective,verb
anxiety	noun
atmosphere	noun
awareness	noun
band	noun,verb
bath	noun
block	noun,verb
bone	noun,verb,adverb
bread	noun
calendar	noun,verb
candidate	noun
cap	noun,verb
careful	adjective
climate	noun
coat	noun,verb
collect	verb,adverb,noun
combine	verb,noun
command	verb,noun
comparison	noun
confusion	noun
construction	noun
contest	noun,verb
corner	noun,adjective,verb,idiom
court	noun,verb,idiom
cup	noun,verb
dig	verb,noun
district	noun,verb
divide	verb,noun
door	noun,idiom
east	noun,adjective,adverb
elevator	noun
elsewhere	adverb
emotion	noun
employee	noun
employer	noun
equivalent	adjective,noun
everywhere	adverb
except	preposition,conjunction,idiom
finger	noun,verb,idiom
garage	noun,verb
guarantee	noun,verb
guest	noun
hang	verb,noun,idiom
height	noun
himself	pronoun
hole	noun,verb,idiom
hook	noun,verb,idiom
hunt	verb,noun
implement	noun,verb
initial	adjective,noun,verb
intend	verb
introduce	verb
latter	adjective
layer	noun,verb
leadership	noun
lecture	noun,verb
lie	noun,verb,idiom
mall	noun
manager	noun
manner	noun,idiom
march	verb,noun,idiom
married	past,verb,adjective,noun
meeting	noun,idiom
mention	verb,noun,idiom
narrow	adjective,verb,noun
nearby	adjective,adverb
neither	conjunction,adjective,pronoun
nose	noun,verb,idiom
obviously	adverb
operation	noun
parking	noun,adjective
partner	noun,verb
perfectly	adverb
physically	adverb
profile	noun,verb
proud	adjective,idiom
recording	noun
relate	verb
respect	noun,verb
rice	noun,verb
routine	noun,adjective
sample	noun
schedule	noun,verb
settle	verb
smell	verb,noun
somehow	adverb,idiom
spiritual	adjective,noun
survey	verb,noun
swimming	noun,adjective
telephone	noun,verb
tie	verb,noun,idiom
tip	noun,verb
transportation	noun
unhappy	adjective
wild	adjective,adverb,noun,idiom
winter	noun,adjective,verb
absolutely	adverb,interjection
acceptable	adjective
adult	adjective,noun
aggressive	adjective
airline	noun,adjective
apart	adjective,adverb
assure	verb
attract	verb
bag	noun,verb
battle	noun,verb
bed	noun,verb
bill	noun,verb
boring	adjective
bother	noun,verb
brief	adjective,noun,verb
cake	noun,verb
charity	noun
code	noun,verb
cousin	noun
crazy	adjective,noun,idiom
curve	noun,verb,idiom
designer	noun,adjective
dimension	noun,verb
disaster	noun
distinct	adjective
distribute	verb
dress	noun,adjective,verb
ease	noun,verb
eastern	adjective
editor	noun
efficiency	noun
emergency	noun,adjective
escape	verb,noun,adjective
evening	noun,adjective
excitement	noun
expose	verb,idiom
extension	noun,adjective
extent	noun
farm	noun,verb,idiom
feedback	noun
fight	noun,verb
gap	noun,verb
gather	verb,noun,idiom
grade	noun,verb
guitar	noun
hate	verb,noun
holiday	noun,adjective,verb
homework	noun
horror	noun,adjective
horse	noun,verb,adjective,idiom
host	noun,verb
husband	noun,verb
leader	noun
loan	noun,verb,idiom
logical	adjective
mistake	noun,verb,idiom
mom	noun
mountain	noun,adjective,idiom
nail	noun,verb,idiom
noise	noun,verb
none	pronoun,adverb,adjective
occasion	noun,verb,idiom
outcome	noun
overcome	verb
owe	verb
package	noun,verb
patient	noun,adjective
pause	noun,verb,idiom
permission	noun
phrase	noun,verb
presentation	noun
prior	adjective,noun,idiom
promotion	noun
proof	noun,adjective,verb
race	noun,verb
reasonable	adjective
reflection	noun
refrigerator	noun
relief	noun,idiom
repair	verb,noun
resolution	noun
revenue	noun
rough	adjective,noun,adverb,verb
sad	adjective,noun
sand	noun,verb,idiom
scratch	verb,noun,adjective,idiom
sentence	noun,verb
session	noun
shoulder	noun,verb,idiom
sick	adjective,noun,idiom
singer	noun
smoke	noun,verb,idiom
stomach	noun,verb
strange	adjective,adverb
strict	adjective
strike	verb,noun,adjective,idiom
string	noun,verb,idiom
succeed	verb
successfully	adverb
suddenly	adverb
suffer	verb
surprised	past,verb
tennis	noun
throw	verb
tourist	noun,adverb
towel	noun,verb
truly	adverb
vacation	noun,verb
virtually	adverb
west	noun,adjective,adverb,idiom
wheel	noun,verb,idiom
wine	noun,adjective,verb,idiom
acquire	verb
adapt	verb
adjust	verb
administrative	adjective
altogether	adverb
anyway	adverb
argue	verb
arise	verb
arm	noun,verb
aside	noun,adverb
associate	noun,verb,adjective
automatic	adjective
automatically	adverb
basket	noun
bet	noun,verb
blow	noun,verb
bonus	noun
border	noun,verb
branch	noun,verb
breast	noun,verb
brother	noun,interjection
buddy	noun,verb
bunch	noun,verb
cabinet	noun
childhood	noun
chip	noun,verb
church	noun
civil	adjective
clothes	noun
coach	noun,verb,adverb
coffee	noun
confirm	verb
cross	noun,verb,adjective
deeply	adverb
definitely	adverb
deliberately	adverb
dinner	noun
document	noun,verb
draft	noun,verb,adjective
drawing	noun
dust	noun,verb
employ	verb,noun
encouraging	verb
expert	noun,adjective
external	adjective,noun
floor	noun,verb
former	adjective
god	noun,interjection
golf	noun,verb
habit	noun,verb
hair	noun
hardly	adverb
hearing	noun
hurt	verb,noun
illegal	adjective,noun
incorporate	verb
initiative	noun
iron	noun,verb
judge	noun,verb
judgment	noun
justify	verb
knife	noun,verb
lab	noun
landscape	noun,verb
laugh	verb,noun
lay	verb,noun,adjective
league	noun,verb
loud	adjective,adverb
mail	noun,verb
massive	adjective
measurement	noun
mess	noun,verb
mobile	adjective,noun
mode	noun
mud	noun
nasty	adjective,noun
native	noun,adjective
opening	noun,adjective
orange	noun
ordinary	adjective,noun
organize	verb
ought	verb
parent	noun,verb
pattern	noun,verb
pin	noun,verb
poetry	noun
police	noun
pool	noun,verb
possess	verb
possibility	noun
pound	noun,verb
procedure	noun
queen	noun
ratio	noun
readily	adverb
relation	noun
relieve	verb
request	noun,verb
respond	verb,noun
restaurant	noun
retain	verb
royal	adjective,noun
salary	noun,verb
satisfaction	noun
sector	noun
senior	adjective,noun
shame	noun,verb
shelter	noun,verb
shoe	noun,verb
shut	verb
signature	noun
significance	noun
silver	noun,adjective,verb
somebody	pronoun
song	noun
southern	adjective
split	verb,noun
strain	verb,noun
struggle	verb,noun
super	adjective,adverb,noun
swim	verb,noun
tackle	noun,verb
tank	noun,verb
terribly	adverb
tight	adjective,adverb
tooth	noun
town	noun
train	verb,noun
trust	noun,verb
unfair	adjective
unfortunately	adverb
upper	adjective,noun
vehicle	noun
visible	adjective
volume	noun
wash	verb,noun
waste	verb,adjective,noun
wife	noun
yellow	adjective,noun,verb
yours	pronoun
accident	noun
airport	noun
alive	adjective
angry	adjective
appointment	noun
arrival	noun
assist	noun,verb
assumption	noun
bake	noun,verb
bar	noun,verb,preposition
baseball	noun
bell	noun,verb
bike	noun,verb
blame	noun,verb
boy	noun,interjection
brick	noun,verb
calculate	verb
chair	noun,verb
chapter	noun
closet	noun,verb,adjective
clue	noun,verb
collar	noun,verb
comment	noun,verb
committee	noun
compete	verb
concerning	preposition
conference	noun,verb
consult	verb
conversation	noun
convert	verb,noun
crash	verb,noun,adjective,adverb
database	noun
deliver	verb
dependent	adjective,noun
desperate	adjective
devil	noun,verb
diet	noun,verb
enthusiasm	noun
error	noun
exciting	adjective
explanation	noun
extend	verb
farmer	noun
fear	noun,verb
fold	verb,noun
forth	adverb
friendly	adjective
fuel	noun,verb
funny	adjective,noun
gate	noun
girl	noun
glove	noun,verb
grab	verb,noun
gross	adjective,adverb,verb,noun
hall	noun
herself	pronoun
hide	verb,noun
historian	noun
hospital	noun
ill	adjective,adverb,noun
injury	noun
instruction	noun
investigate	verb
jacket	noun,verb
lucky	adjective
lunch	noun,verb
maintenance	noun
manufacturer	noun
meal	noun
miss	verb,noun
monitor	noun,verb
mortgage	noun,verb
negotiate	verb
nurse	noun,verb
pace	noun,verb,preposition
panic	noun,verb
peak	noun,verb,adjective
perception	noun
permit	verb,noun
pie	noun
plane	noun,adjective,verb
poem	noun
presence	noun
proposal	noun
provided	past,verb
qualify	verb
quote	verb,noun
realistic	adjective
reception	noun
recover	verb,noun
replacement	noun
resolve	verb,noun
retire	verb
revolution	noun
reward	noun,verb
rid	verb
river	noun
roll	verb,noun
row	noun,verb
sandwich	noun,verb
shock	noun,verb
sink	verb,noun
slip	verb,noun
son	noun
sorry	adjective
spare	adjective,noun,verb
speech	noun
spite	noun,verb
spray	noun,verb
surprise	noun,verb
suspect	verb,noun,adjective
sweet	adjective,noun
swing	verb,noun
tea	noun
till	noun,verb
transition	noun,verb
twist	verb,noun
ugly	adjective
unlikely	adjective
upstairs	adjective,noun
usual	adjective,noun
village	noun
warning	noun
weekend	noun,verb
weigh	verb
welcome	noun,interjection,verb,adjective
winner	noun
worker	noun
writer	noun
yard	noun,verb
abroad	adverb,noun
alarm	noun,verb
anxious	adjective
arrive	verb
assistance	noun
attach	verb
behave	verb
bend	noun,verb
bicycle	noun,verb
bite	noun,verb
blind	noun,verb,adjective,adverb
bottle	noun,verb
brave	adjective,noun,verb
breath	noun
briefly	adverb
buyer	noun
cable	noun,verb
calm	adjective,noun,verb
candle	noun,verb
celebrate	verb
chest	noun
chocolate	noun
clerk	noun,verb
cloud	noun,verb
comprehensive	adjective
concentrate	verb,noun
concert	noun,verb
conclusion	noun
contribution	noun
convince	verb
cookie	noun
counter	noun,verb,adverb,adjective
courage	noun
curious	adjective
dad	noun
desk	noun
dirty	adjective,verb
disagree	verb
downtown	adjective,adverb,noun
drawer	noun
establish	verb
establishment	noun
estimate	verb,noun
examination	noun
flower	noun,verb
garbage	noun
grand	adjective,noun
grandfather	noun,verb
grocery	noun
harm	noun,verb
honest	adjective,adverb
honey	noun
ignore	verb
imply	verb
impression	noun
impressive	adjective
improvement	noun
independence	noun
informal	adjective
inner	adjective
insect	noun
insist	verb
inspection	noun
inspector	noun
king	noun
knee	noun,verb
ladder	noun
lawyer	noun,verb
leather	noun,adjective,verb
load	noun,verb
loose	adjective,verb
male	adjective,noun
menu	noun
mine	pronoun,noun,verb
mirror	noun,verb
moreover	adverb
neck	noun,verb
penalty	noun
pension	noun,verb
piano	noun
plate	noun,verb
pleasant	adjective
pleased	past,verb
potato	noun
profession	noun
professor	noun
prompt	verb,noun,adjective
proposed	past,verb
purple	noun,adjective,verb
pursue	verb
quantity	noun
quiet	adjective,noun,verb
reaction	noun
refuse	verb,noun
regret	verb,noun
remaining	verb
requirement	noun
reveal	verb,noun
ruin	noun,verb
rush	verb,noun
salad	noun
sexual	adjective
shake	verb,noun
shift	verb,noun
shine	verb,noun
ship	noun,verb
sister	noun
skirt	noun,verb
slice	noun,verb
snow	noun,verb
specialist	noun,adjective
specify	verb
steal	verb,noun
stroke	noun,verb
strongly	adverb
suck	verb,noun
sudden	adjective
supermarket	noun
surround	verb,noun
switch	noun,verb
terrible	adjective
tired	past,verb
tongue	noun
trash	noun,verb
tune	noun,verb
unable	adjective
warn	verb
weak	adjective
weakness	noun
wedding	noun
wooden	adjective
worried	past,verb
yeah	adverb,interjection
zone	noun,verb
accuse	verb
admire	verb
admit	verb
adopt	verb
affair	noun
ambition	noun
analyst	noun
anger	noun,verb
announce	verb
anybody	pronoun,noun
apologize	verb
apple	noun
approve	verb
asleep	adjective
assignment	noun
assistant	noun
attend	verb
award	noun,verb
bathroom	noun
bear	verb,noun
bedroom	noun
beer	noun
belong	verb
bid	noun,verb
birthday	noun
bitter	noun,adjective
boot	noun,verb
brilliant	adjective,noun
bug	noun,verb
camp	noun,verb,adjective
candy	noun,verb
carpet	noun,verb
cat	noun,verb
celebration	noun
champion	noun,verb
championship	noun
channel	noun,verb
cheek	noun
client	noun
clock	noun,verb
comfort	noun,verb
commit	verb
confident	adjective
conscious	adjective
consequence	noun
cow	noun,verb
crack	noun,verb,adjective
criticize	verb
dare	verb,noun
dear	adjective,noun,adverb,interjection
decent	adjective
delay	verb,noun
departure	noun
deserve	verb
destroy	verb
diamond	noun
dirt	noun
disappointed	past,verb
drunk	adjective,noun
ear	noun
embarrassed	adjective
empty	adjective,verb,noun
engineer	noun,verb
entrance	noun,verb
fault	noun,verb
female	adjective,noun
fortune	noun
friendship	noun
funeral	noun
gene	noun
girlfriend	noun
grass	noun,verb
guilty	adjective
guy	noun,verb
hat	noun
hell	noun,interjection
hesitate	verb
highlight	noun,verb
honestly	adverb
hurry	verb,noun
illustrate	verb
incident	noun,adjective
indication	noun
inevitable	adjective,noun
inform	verb
intention	noun
invite	verb,noun
island	noun,verb
joke	noun,verb
jury	noun,verb,adjective
kiss	verb,noun
lady	noun
leg	noun,verb
lip	noun,verb
lonely	adjective
mad	adjective
manufacturing	verb
marry	verb,interjection
mate	noun,verb
midnight	noun
motor	noun,adjective,verb
neat	adjective,noun
negotiation	noun
nerve	noun,verb
nervous	adjective
nowhere	adverb,pronoun,adjective
obligation	noun
odd	adjective
ok	adjective,adverb,noun,verb
passage	noun,verb
passenger	noun
pen	noun,verb
persuade	verb
pizza	noun
platform	noun
poet	noun
pollution	noun
pop	verb,noun,adverb,adjective
pour	verb
pray	verb,adverb
pretend	verb,adjective
previously	adverb
pride	noun,verb
priest	noun,verb
prize	noun,adjective,verb
promise	noun,verb
propose	verb
punch	verb,noun
quit	verb,noun
recognition	noun
remarkable	adjective
remind	verb
reply	verb,noun
representative	adjective,noun
reputation	noun
resident	noun,adjective
resist	verb,noun
resort	noun,verb
ring	noun,verb
rip	verb,noun
roof	noun,verb
rope	noun,verb
rub	verb,noun
sail	noun,verb
scheme	noun,verb
script	noun,verb
shall	verb
shirt	noun
silly	adjective,noun
sir	noun
slight	adjective,verb,noun
smart	adjective,verb,noun
smile	verb,noun
sock	noun,verb
speaker	noun
spell	verb,noun
station	noun,verb
stranger	noun
stretch	verb,noun
stupid	adjective,noun
submit	verb
substantial	adjective
suppose	verb
surgery	noun
suspicious	adjective
sympathy	noun
tale	noun
tall	adjective
tear	verb,noun
temporary	adjective,noun
throat	noun
tiny	adjective
toe	noun,verb
tomorrow	adverb,noun
tower	noun,verb
trainer	noun
translate	verb
truck	noun,verb
uncle	noun
wake	verb,noun
weekly	adjective,adverb,noun
whoever	pronoun
witness	noun,verb
wrap	verb,noun
yesterday	adverb,noun
youth	noun
